-@-@-@-----
-@-@-@-@@@-
---@-@-@---
@@-@-@-@@@@
-----------
@@-@-@-@@@@
-@-@-@-@---
-@-@@@@@-@@
-----------
@@@@-@@@@@@
-------@---
@@-@@@-@-@@
---@-------
@@-@@@@@@@-
-------@---
-@@@-@-@@@-
---@-@-@---
@@@@@@-@-@@
-------@---