-----------@-@---------@---@-----@-----@-
@@@@@@@@-@@@-@@@@@-@-@@@-@@@-@-@@@@@-@@@-
-@-----@-----@-----@---------@-------@---
-@-@-@-@@@-@@@-@@@-@@@@@@@@@@@-@-@-@@@-@-
---@-@-@-----@-@-----@-----@-@-@-@-@---@-
@@-@@@@@-@@@-@-@@@@@@@-@@@@@-@-@-@-@@@-@@
-@-----@-@-@-----@---@-@-------@-@---@---
-@-@-@-@@@-@@@-@-@-@@@-@-@@@@@@@-@@@-@-@@
---@-@---@-@-@-@-------@-----@-@---@-@---
@@@@@@-@@@-@-@@@@@-@@@-@@@@@@@-@-@@@-@-@-
-@---@-@-----@-----@---------@---@-@---@-
-@-@-@-@@@@@-@@@@@@@-@@@@@@@-@@@-@-@-@@@@
-@-@-----------------@-------@-@-@---@---
-@@@-@-@@@@@@@-@@@-@@@@@-@@@-@-@@@@@@@-@@
-@---@---@---@-@-@---@-----@-@-@-@-------
-@@@-@-@@@-@@@-@-@@@-@-@@@@@@@-@-@-@@@@@-
-----@---@-@-@---@-@-@---------@-------@-
@@@@-@@@@@-@-@@@@@-@@@@@-@-@@@-@@@@@-@@@@
-@-----@---@-----------@-@-@---@---@-----
-@-@-@-@@@-@@@-@@@-@@@@@-@-@@@@@-@@@@@-@@
-@-@-@-@-@-@---@---@-@---@-@---------@---
-@@@-@@@-@-@-@-@@@@@-@@@@@@@@@@@-@@@@@-@@
-----@-----@-@-@-@---@-----------@-@-@-@-
-@-@-@@@@@-@-@-@-@-@-@-@-@@@@@-@-@-@-@-@-
-@-@---@-----@-@-@-@-@-@---@---@-@-----@-
-@@@@@@@@@@@@@-@-@-@@@@@@@-@@@@@-@@@-@@@-
---@-----------@-@-----@---@---@---@---@-
@@-@-@@@@@@@@@-@-@-@-@@@-@-@@@-@-@-@-@@@-
-@---@-@-@---@-----@-----@---@-@-@-------
-@-@@@-@-@-@@@-@@@-@@@@@@@-@@@-@@@-@@@-@-
---------@-----@-------@-@-----@---@---@-
@@-@-@@@@@-@@@@@@@-@-@@@-@-@@@@@@@-@@@@@-
---@---@-----@-----@---@-----@---------@-