-------@-@---------@-----------@-@-@---
-@-@-@@@-@@@-@@@@@@@-@@@@@@@-@@@-@-@-@-
-@-@-----------@-----@-@---@---@-@-@-@-
@@@@@@-@@@@@@@-@-@@@@@-@-@@@@@-@-@-@-@-
-----@---@-@-----@-----@---@-------@-@-
-@@@-@-@@@-@-@@@@@-@@@-@-@@@@@-@@@-@-@-
-@---@---@---@-@-@-@---@---@---@-----@-
-@@@-@@@@@@@@@-@-@@@-@-@-@@@@@@@-@@@-@-
-@-@---@-@-----@-----@-@---@-------@-@-
@@-@-@-@-@-@@@-@-@@@@@@@-@-@@@-@-@@@-@-
-----@-------@-----------@-@---@-@-@-@-
@@@@-@-@@@-@@@@@@@@@-@@@@@-@-@-@@@-@@@@
-----@---@---------@-----@---@---------