---@-@-@-------------@-
-@@@-@-@-@@@-@@@-@@@-@-
---------@---@-----@---
@@-@@@@@@@-@@@@@-@@@@@@
---@---@-----@-------@-
-@-@-@@@-@@@-@-@@@@@@@-
-@-@-------@-@---------
-@-@@@-@@@@@@@@@@@@@@@-
-@---@-@-@-@-@-@-@-----
-@@@@@@@-@-@-@-@-@@@-@-
---@-------------@-@-@-
-@@@@@@@-@-@@@@@-@-@@@-
-@-------@-@---------@-
-@-@@@-@@@@@-@@@@@@@@@-
-@-@---@-------------@-
@@-@-@@@@@@@-@-@@@@@-@-
-@-@-@-@---@-@-@-@-----
-@-@-@-@-@-@@@-@-@@@-@@
---@---@-@-----@-----@-
-@@@@@@@@@@@@@-@@@-@-@-
---------@-------@-@---